00000000000000000000000000000000000000000000000000000000000000000000
00100000000000000000000000000000000000000000000000000000000000000000
01100000000000000006000000000000000000000000000000000000000000000000
11100000000000000000000000000000000000000000000000000000002222222222
11100000022222000000000000000000000000000000000000022222000000000000
11100000000000000000000000000000000000000000000000000000000000000000
11110000000000000001100000011000000000000000000000000000000000000000
11111111111111111551100001111111111111111111111554444444444444444444
11111111111111111441144444411111111111111111111444444444444444444444
11111111111111111441144444111111111111111111444444444444444444444444
11111111111111111441144444144111111111111144444444444444444444444444
11111111111111111441144444144444411111144444444444444444444444444444
11111111111111111441144444444444441114444444444444444444444444444444
44444444444444444444444444444444444144444444444444444444444444444444