00000000000000000000000000000000000000000000000000000000000000000000000000000000000000000000000000000000000000000000000000000000000000000000000000000000000000000000000000000000000000
00100000000000000000000000000000000000000000000000000000000000000000000000000000000000000000000000000000000000000000000000000000000000000000000000000000000000000000000000000022222000
01100000000000000006000000000000000000000000000000000000000000000000000000000000000000000000000000000000000000000000000000000000000000000000000001100000000000000022222222200000000000
11100000000000000000000000000000000000000000000000000000022222222222220000000000000000000000000000000000000000000000000000000000000000000000000111110000000000000000000000000000000000
11100000022222000000000000000000000000000000000002222222000000000000000000000000000000000000600000000000000000000000000000000000002222200000011111111000000022222000000000000000222220
11100000000000000000000000000000000000000000000000000000000000000000000000000000000000000000000000000000000000000000000000000000000000000011111111111100000000000000000000000000000000
11110000000000000001100000011000000000000000000000000000000000000000000000000000000000000000000007000000000000000000000000000000000000000011111111111100000000000000000000000000000000
11111111111111111551100111111111111111111111111550000000000000000000000551111111111110011111111111000000000000000000000000000111110000001111111111111111155500000000000000005500000011
11111111111111111441144444411111111111111111111444444444444444444444444441111111114444444414114444444444444444444444444444444444444444444444444444444444444444444444444444444444444444
11111111111111111441144444111111111111111111444444444444444444444444444444441144444444444444444444444444444444444444444444444444444444444444444444444444444444444444444444444444444444
11111111111111111441144444144111111111111144444444444444444444444444444444444444444444444444444444444444444444444444444444444444444444444444444444444444444444444444444444444444444444
11111111111111111441144444144444411111144444444444444444444444444444444444444444444444444444444444444444444444444444444444444444444444444444444444444444444444444444444444444444444444
11111111111111111441144444444444441114444444444444444444444444444444444444444444444444444444444444444444444444444444444444444444444444444444444444444444444444444444444444444444444444
44444444444444444444444444444444444144444444444444444444444444444444444444444444444444444444444444444444444444444444444444444444444444444444444444444444444444444444444444444444444444
44444444444444444444444444444444444144444444444444444444444444444444444444444444444444444444444444444444444444444444444444444444444444444444444444444444444444444444444444444444444444
44444444444444444444444444444444444144444444444444444444444444444444444444444444444444444444444444444444444444444444444444444444444444444444444444444444444444444444444444444444444444
